//MAP CONVERTED BY dmm2tgm.py THIS HEADER COMMENT PREVENTS RECONVERSION, DO NOT REMOVE
"a" = (
/turf/open/floor/grass,
/area/space)
"b" = (
/obj/effect/turf_decal/weather/sand,
/turf/open/floor/grass,
/area/space)
"c" = (
/turf/open/misc/beach/coast,
/area/space)
"e" = (
/turf/closed/indestructible/riveted,
/area/space)
"g" = (
/turf/closed/wall/r_wall,
/area/space)
"h" = (
/obj/structure/railing{
	dir = 4
	},
/turf/open/floor/iron/textured_large,
/area/space)
"i" = (
/turf/open/misc/beach/sand,
/area/space)
"k" = (
/obj/machinery/door/airlock/public/glass,
/turf/open/floor/iron/textured_large,
/area/space)
"l" = (
/turf/open/floor/iron/smooth_large,
/area/space)
"o" = (
/obj/effect/turf_decal/weather/sand{
	dir = 9
	},
/turf/open/floor/grass,
/area/space)
"q" = (
/obj/effect/turf_decal/weather/sand{
	dir = 6
	},
/turf/open/floor/grass,
/area/space)
"r" = (
/turf/open/misc/beach/coast{
	dir = 10
	},
/area/space)
"s" = (
/obj/effect/turf_decal/weather/sand{
	dir = 10
	},
/turf/open/floor/grass,
/area/space)
"t" = (
/obj/structure/railing,
/turf/open/floor/iron/textured_large,
/area/space)
"v" = (
/turf/open/floor/iron/white/small,
/area/space)
"w" = (
/turf/open/floor/plating,
/area/space)
"y" = (
/turf/open/floor/iron,
/area/space)
"z" = (
/turf/open/misc/beach/coast/corner{
	dir = 1
	},
/area/space)
"A" = (
/turf/open/floor/iron/small,
/area/space)
"D" = (
/turf/open/floor/iron/textured_large,
/area/space)
"E" = (
/turf/open/floor/iron/white/textured_large,
/area/space)
"G" = (
/turf/open/floor/iron/stairs{
	dir = 8
	},
/area/space)
"H" = (
/obj/structure/barricade/wooden,
/turf/open/floor/grass,
/area/space)
"I" = (
/obj/structure/railing{
	dir = 6
	},
/turf/open/floor/iron/textured_large,
/area/space)
"K" = (
/turf/open/misc/beach/coast{
	dir = 9
	},
/area/space)
"L" = (
/turf/open/misc/beach/coast/corner{
	dir = 4
	},
/area/space)
"M" = (
/turf/open/floor/iron/white/smooth_large,
/area/space)
"O" = (
/obj/structure/barricade/wooden,
/turf/open/floor/iron/stairs{
	dir = 4
	},
/area/space)
"P" = (
/obj/effect/spawner/structure/window/reinforced,
/turf/open/floor/plating,
/area/space)
"Q" = (
/obj/effect/turf_decal/weather/sand{
	dir = 8
	},
/turf/open/floor/grass,
/area/space)
"R" = (
/turf/open/floor/iron/large,
/area/space)
"T" = (
/turf/open/water/beach,
/area/space)
"U" = (
/obj/structure/barricade/wooden,
/turf/open/floor/iron/stairs{
	dir = 8
	},
/area/space)
"V" = (
/turf/open/floor/iron/stairs{
	dir = 4
	},
/area/space)
"X" = (
/turf/open/floor/iron/white,
/area/space)
"Y" = (
/turf/open/misc/beach/coast{
	dir = 8
	},
/area/space)

(1,1,1) = {"
e
e
e
e
e
e
e
e
e
e
e
e
e
e
e
e
e
e
e
e
e
e
e
e
e
e
e
e
e
e
e
e
e
e
e
e
e
e
e
e
e
e
e
e
e
e
e
e
e
e
e
e
e
e
e
e
e
e
e
e
e
e
e
"}
(2,1,1) = {"
e
g
g
g
g
g
g
g
g
g
g
g
g
g
g
g
g
g
g
g
g
g
g
g
g
g
g
g
g
g
g
g
g
g
g
g
g
g
g
g
g
g
g
g
g
g
g
g
g
g
g
g
g
g
g
g
g
g
g
g
g
g
e
"}
(3,1,1) = {"
e
g
a
v
g
w
w
w
w
w
g
l
l
l
l
l
l
l
l
l
g
w
w
w
g
l
l
l
l
l
l
l
l
g
v
v
R
R
R
R
R
R
R
R
R
R
R
R
R
R
R
R
R
R
R
R
R
R
R
R
R
g
e
"}
(4,1,1) = {"
e
g
a
v
g
w
w
w
w
w
g
l
l
l
l
l
l
l
l
l
g
w
w
w
g
l
l
l
l
l
l
l
l
D
v
v
R
R
R
R
R
R
R
R
R
R
R
R
R
R
R
R
R
R
R
R
R
R
R
R
R
g
e
"}
(5,1,1) = {"
e
g
a
v
g
g
g
g
g
g
g
l
l
g
g
g
g
g
l
l
g
g
g
g
g
l
l
l
l
l
l
l
l
D
v
v
R
R
R
R
R
R
R
R
R
R
R
R
R
R
R
R
R
R
R
R
R
R
R
R
R
g
e
"}
(6,1,1) = {"
e
g
a
v
g
l
l
l
l
l
l
l
l
l
l
g
O
g
l
l
l
l
l
l
l
l
l
l
l
l
l
l
l
D
v
v
R
R
R
R
R
R
R
R
R
R
R
R
R
R
R
R
R
R
R
R
R
R
R
R
R
g
e
"}
(7,1,1) = {"
e
g
a
v
g
l
l
l
l
l
l
l
l
l
l
g
O
g
l
l
l
l
l
l
l
l
l
l
l
l
l
l
l
g
v
v
R
R
R
R
R
R
R
R
R
R
R
R
R
R
R
R
R
R
R
R
R
R
R
R
R
g
e
"}
(8,1,1) = {"
e
g
a
v
g
l
l
l
l
l
l
l
l
l
l
g
V
g
l
l
l
l
l
l
l
l
l
g
g
D
D
D
g
g
v
v
R
R
R
R
R
R
R
R
R
R
R
R
R
R
R
R
R
R
R
R
R
R
R
R
R
g
e
"}
(9,1,1) = {"
e
g
a
v
g
l
l
l
l
l
l
l
l
l
l
g
M
g
l
l
l
l
l
l
l
l
l
g
v
v
v
v
v
v
v
v
R
R
R
R
R
R
R
R
R
R
R
R
R
R
R
R
R
R
R
R
R
R
R
R
R
g
e
"}
(10,1,1) = {"
e
g
a
v
g
l
l
l
l
l
l
l
l
g
g
g
M
g
g
g
P
P
g
P
P
g
k
g
v
v
v
v
v
v
v
v
R
R
R
R
R
R
R
R
R
R
R
R
R
R
R
R
R
R
R
R
R
R
R
R
R
g
e
"}
(11,1,1) = {"
e
g
a
v
g
l
l
g
k
k
g
l
l
g
y
t
M
v
v
v
v
v
v
v
v
v
v
v
v
v
v
v
v
v
v
v
R
R
R
R
R
R
R
R
R
R
R
R
R
R
R
R
R
R
R
R
R
R
R
R
R
g
e
"}
(12,1,1) = {"
e
g
a
v
g
g
g
g
v
v
g
g
g
g
h
I
M
v
v
v
v
v
v
v
v
v
v
v
v
v
v
v
a
a
a
a
q
i
c
T
T
T
T
T
T
T
R
R
R
R
T
T
T
T
T
T
T
T
T
T
M
g
e
"}
(13,1,1) = {"
e
g
a
v
v
v
v
v
v
v
v
v
v
v
v
v
M
v
v
v
v
v
v
v
v
v
v
v
v
v
v
v
a
a
a
b
i
i
c
T
T
T
T
T
T
T
R
R
R
R
T
T
T
T
T
T
T
T
T
T
M
g
e
"}
(14,1,1) = {"
e
g
a
v
v
v
v
v
v
v
v
v
v
v
v
v
M
a
a
a
a
a
a
a
a
a
a
a
a
a
a
a
a
a
a
b
i
i
c
T
T
T
T
T
T
T
R
R
R
R
T
T
T
T
T
T
T
T
T
T
M
g
e
"}
(15,1,1) = {"
e
g
a
a
M
g
R
R
R
R
R
R
R
R
R
R
M
a
a
a
a
a
a
a
a
a
a
a
a
a
a
a
a
a
a
b
i
i
c
T
T
T
T
T
T
T
T
R
R
T
T
T
T
T
T
T
T
T
T
T
M
g
e
"}
(16,1,1) = {"
e
g
a
a
M
g
R
R
R
R
R
R
R
R
R
R
M
a
a
a
a
a
a
a
a
a
a
a
a
a
a
a
a
a
a
b
i
i
c
T
T
T
T
T
T
T
T
T
T
T
T
T
T
T
T
T
T
T
T
T
M
g
e
"}
(17,1,1) = {"
e
g
a
a
M
g
R
R
R
R
R
R
R
R
R
R
M
a
a
a
a
a
a
a
a
a
a
a
a
a
a
a
a
a
a
b
i
i
c
T
T
T
T
T
T
T
T
T
T
T
T
T
T
T
T
T
T
T
T
T
M
g
e
"}
(18,1,1) = {"
e
g
a
a
M
g
R
R
R
R
R
R
R
R
R
R
M
a
a
a
a
a
a
a
a
a
a
a
a
a
a
a
a
a
a
b
i
i
z
r
T
T
T
T
T
T
T
T
T
T
T
T
T
T
T
T
T
T
T
T
M
g
e
"}
(19,1,1) = {"
e
g
a
a
G
g
R
R
R
R
R
R
R
R
R
R
M
a
a
a
a
a
a
a
a
a
a
a
a
a
a
a
a
a
a
b
i
i
i
c
T
T
T
T
T
T
T
T
T
T
T
T
T
T
T
T
T
T
T
T
M
g
e
"}
(20,1,1) = {"
e
g
a
H
U
g
R
R
R
R
R
R
R
R
R
R
M
a
a
a
a
a
a
a
a
a
a
a
a
a
a
a
a
a
a
a
s
i
i
c
T
T
T
T
T
T
T
T
T
T
T
T
T
T
T
T
T
T
T
T
M
g
e
"}
(21,1,1) = {"
e
g
H
a
U
g
R
R
R
R
R
R
R
R
R
R
M
a
a
a
a
a
a
a
a
a
a
a
a
a
a
a
a
a
a
a
b
i
i
c
T
T
T
T
T
T
T
T
T
T
T
T
T
T
T
T
T
T
T
T
M
g
e
"}
(22,1,1) = {"
e
g
g
g
g
g
R
R
R
R
R
R
R
R
R
R
M
a
a
a
a
a
a
a
a
a
a
a
a
a
a
a
a
a
a
a
b
i
i
c
T
T
T
T
T
T
T
T
T
T
T
T
T
T
T
T
T
T
T
T
M
g
e
"}
(23,1,1) = {"
e
w
w
w
w
g
R
R
R
R
R
R
R
R
R
R
M
a
a
a
a
a
a
a
a
a
a
a
a
a
a
a
a
a
a
a
b
i
i
c
T
T
T
T
T
T
T
T
T
T
T
T
T
T
T
T
T
T
T
T
M
g
e
"}
(24,1,1) = {"
e
w
w
w
w
g
R
R
R
R
R
R
R
R
R
R
M
a
a
a
a
a
a
a
a
a
a
a
a
a
a
a
a
a
a
a
a
s
i
c
T
T
T
T
T
T
T
T
T
T
T
T
T
T
T
T
T
T
T
T
M
g
e
"}
(25,1,1) = {"
e
w
w
w
w
g
R
R
R
R
R
R
R
R
R
R
M
a
a
a
a
a
a
a
a
a
a
a
a
a
a
a
a
a
a
a
a
b
i
c
T
T
T
T
T
T
T
T
T
T
T
T
T
T
T
T
T
T
T
T
M
g
e
"}
(26,1,1) = {"
e
w
w
w
w
g
R
R
R
R
R
R
R
R
R
R
M
a
a
a
a
a
a
a
a
a
a
a
a
a
a
a
a
a
a
a
a
b
i
c
T
T
T
T
T
T
T
T
T
T
T
T
T
T
T
T
T
T
T
T
M
g
e
"}
(27,1,1) = {"
e
w
w
w
w
g
g
g
E
E
E
E
E
g
g
g
M
a
a
a
a
a
a
a
a
a
a
a
a
a
a
a
a
a
a
a
a
b
i
c
T
T
T
T
T
T
T
T
T
T
T
T
T
T
T
T
T
T
T
T
M
g
e
"}
(28,1,1) = {"
e
w
w
w
w
g
X
X
X
X
X
X
X
X
X
g
M
a
a
a
a
a
a
a
a
a
a
a
a
a
a
a
a
a
a
a
a
b
i
c
T
T
T
T
T
T
T
T
T
T
T
T
T
T
T
T
T
T
T
T
M
g
e
"}
(29,1,1) = {"
e
w
w
w
w
g
X
X
X
X
X
X
X
X
X
g
M
a
a
a
a
a
a
a
a
a
a
a
a
a
a
a
a
a
a
a
a
b
i
c
T
T
T
T
T
T
T
T
T
T
T
T
T
T
T
T
T
T
T
T
M
g
e
"}
(30,1,1) = {"
e
w
w
w
w
g
X
X
X
X
X
X
X
X
X
g
M
a
a
a
a
a
a
a
a
a
a
a
a
a
a
a
a
a
a
a
a
b
i
c
T
T
T
T
T
T
T
T
T
T
T
T
T
T
T
T
T
T
T
T
M
g
e
"}
(31,1,1) = {"
e
w
w
w
w
g
X
X
X
X
X
X
X
X
X
g
M
a
a
a
a
a
a
a
a
a
a
a
a
a
a
a
a
a
a
a
a
b
i
c
T
T
T
T
T
T
T
T
T
T
T
T
T
T
T
T
T
T
T
T
M
g
e
"}
(32,1,1) = {"
e
w
w
w
w
g
X
X
X
X
X
X
X
X
X
g
M
a
a
a
a
a
a
a
a
a
a
a
a
a
a
a
a
a
a
a
a
b
i
z
r
T
T
T
T
T
T
T
T
T
T
T
T
T
T
T
T
T
T
T
M
g
e
"}
(33,1,1) = {"
e
w
w
w
w
g
X
X
X
X
X
X
X
X
X
g
M
a
a
a
a
a
a
a
a
a
a
a
a
a
a
a
a
a
a
a
a
b
i
i
c
T
T
T
T
T
T
T
T
T
T
T
T
T
T
T
T
T
T
T
M
g
e
"}
(34,1,1) = {"
e
g
g
g
g
g
X
X
X
X
X
X
X
X
X
g
M
a
a
a
a
a
a
a
a
a
a
a
a
a
a
a
a
a
a
a
a
b
i
i
c
T
T
T
T
T
T
T
T
T
T
T
T
T
T
T
T
T
T
T
M
g
e
"}
(35,1,1) = {"
e
g
X
X
X
X
X
X
X
X
X
X
X
X
X
g
M
a
a
a
a
a
a
a
a
a
a
a
a
a
a
a
a
a
a
a
a
a
s
i
c
T
T
T
T
T
T
T
T
T
T
T
T
T
T
T
T
T
T
T
M
g
e
"}
(36,1,1) = {"
e
g
X
X
X
X
X
X
X
X
X
X
X
X
X
g
M
a
a
a
a
a
a
a
a
a
a
a
a
a
a
a
a
a
a
a
a
a
b
i
z
r
T
T
T
T
T
T
T
T
T
T
T
T
T
T
T
T
T
T
M
g
e
"}
(37,1,1) = {"
e
g
X
X
X
X
X
X
X
X
X
X
X
X
X
g
M
a
a
a
a
a
a
a
a
a
a
a
a
a
a
a
a
a
a
a
a
a
b
i
i
z
Y
r
T
T
T
T
T
T
T
T
T
T
T
T
T
T
K
Y
M
g
e
"}
(38,1,1) = {"
e
g
X
X
X
X
X
X
X
X
X
X
X
X
X
g
M
a
a
a
a
a
a
a
a
a
a
a
a
a
a
a
a
a
a
a
a
a
b
i
i
i
i
z
Y
Y
Y
Y
Y
Y
Y
Y
Y
Y
Y
Y
Y
Y
L
i
M
g
e
"}
(39,1,1) = {"
e
g
X
X
X
X
X
X
X
X
X
X
X
X
X
g
M
a
a
a
a
a
a
a
a
a
a
a
a
a
a
a
a
a
a
a
a
a
a
Q
Q
s
i
i
i
i
i
i
i
i
i
i
i
i
i
i
i
i
i
i
M
g
e
"}
(40,1,1) = {"
e
g
X
X
X
X
X
X
X
X
X
X
X
X
X
g
M
a
a
a
a
a
a
a
a
a
a
a
a
a
a
a
a
a
a
a
a
a
a
a
a
a
Q
Q
Q
Q
Q
Q
s
i
i
i
i
i
i
i
o
Q
Q
Q
M
g
e
"}
(41,1,1) = {"
e
g
X
X
X
X
X
X
X
X
X
X
X
X
X
k
M
a
a
a
a
a
a
a
a
a
a
a
a
a
a
a
a
a
a
a
a
a
a
a
a
a
a
a
a
a
a
a
a
Q
Q
Q
Q
Q
Q
Q
a
a
a
a
M
g
e
"}
(42,1,1) = {"
e
g
g
g
g
g
X
X
X
X
X
X
X
X
X
g
M
a
a
a
a
a
a
a
a
a
a
a
a
a
a
a
a
a
a
a
a
a
a
a
a
a
a
a
a
a
a
a
a
a
a
a
a
a
a
a
a
a
a
a
M
g
e
"}
(43,1,1) = {"
e
w
w
w
w
g
X
X
X
X
X
X
X
X
X
g
M
a
a
a
a
a
a
a
a
a
a
a
a
a
a
a
a
a
a
a
a
a
a
a
a
a
a
a
a
a
a
a
a
a
a
a
a
a
a
a
a
a
a
a
M
g
e
"}
(44,1,1) = {"
e
w
w
w
w
g
X
X
X
X
X
X
X
X
X
g
M
a
a
a
a
a
a
a
a
a
a
a
a
a
a
a
a
a
a
a
a
a
a
a
a
a
a
a
a
a
a
a
a
a
a
a
a
a
a
a
a
a
a
a
M
g
e
"}
(45,1,1) = {"
e
g
g
g
g
g
g
g
E
E
g
g
g
g
g
g
M
a
a
a
a
a
a
a
a
a
a
a
a
a
a
a
a
a
a
a
a
a
a
a
a
a
a
a
a
a
a
a
a
a
a
a
a
a
a
a
a
a
a
a
M
g
e
"}
(46,1,1) = {"
e
g
X
X
X
X
X
X
X
X
X
X
X
X
X
g
M
a
a
a
a
a
a
a
a
a
a
a
a
a
a
a
a
a
a
a
a
a
a
a
a
a
a
a
a
a
a
a
a
a
a
a
a
a
a
a
a
a
a
a
M
g
e
"}
(47,1,1) = {"
e
g
X
X
X
X
X
X
X
X
X
X
X
X
X
g
M
a
a
a
a
a
a
a
a
a
a
a
a
a
a
a
a
a
a
a
a
a
a
a
a
a
a
a
a
a
a
a
a
a
a
a
a
a
a
a
a
a
a
a
M
g
e
"}
(48,1,1) = {"
e
g
g
E
E
g
g
g
g
g
g
g
E
E
g
g
M
a
a
a
a
a
a
a
a
a
a
a
a
a
a
a
a
a
a
a
a
a
a
a
a
a
a
a
a
a
a
a
a
a
a
a
a
a
a
a
a
a
a
a
M
g
e
"}
(49,1,1) = {"
e
g
X
X
X
X
X
X
X
X
X
X
X
X
X
g
M
a
a
a
a
a
a
a
a
a
a
a
a
a
a
a
a
a
a
a
a
a
a
a
a
a
a
v
v
v
v
v
v
v
v
v
v
v
v
v
v
v
a
a
M
g
e
"}
(50,1,1) = {"
e
g
X
X
X
X
X
X
X
X
X
X
X
X
X
g
M
a
a
a
a
a
a
a
a
a
a
a
a
a
a
a
a
a
a
a
a
a
a
a
a
a
a
v
v
v
v
v
v
v
v
v
v
v
v
v
v
v
a
a
M
g
e
"}
(51,1,1) = {"
e
g
X
X
X
X
X
X
X
X
X
X
X
X
X
g
M
a
a
a
a
a
a
a
a
a
a
a
a
a
a
a
a
a
a
a
a
a
a
a
a
a
a
v
g
g
g
g
g
E
E
E
g
g
g
g
g
v
a
a
M
g
e
"}
(52,1,1) = {"
e
g
X
X
X
X
X
X
X
X
X
X
X
X
X
g
M
a
a
a
a
a
a
a
a
a
a
a
a
a
a
a
a
a
a
a
a
a
a
a
a
a
a
v
g
A
A
A
A
A
A
A
A
A
A
A
g
v
a
a
M
g
e
"}
(53,1,1) = {"
e
g
X
X
X
X
X
X
X
X
X
X
X
X
X
g
M
a
a
a
a
a
a
a
a
a
a
a
a
a
a
a
a
a
a
a
a
a
a
a
a
a
a
v
g
A
A
A
A
A
A
A
A
A
A
A
g
v
a
a
M
g
e
"}
(54,1,1) = {"
e
g
X
X
X
X
X
X
X
X
X
X
X
X
X
g
M
a
a
a
a
a
a
a
a
a
a
a
a
a
a
a
a
a
a
a
a
a
a
a
a
a
a
v
g
A
A
A
A
A
A
A
A
A
A
A
g
v
a
a
M
g
e
"}
(55,1,1) = {"
e
g
X
X
X
X
X
X
X
X
X
X
X
X
X
g
M
a
a
a
a
a
a
a
a
a
a
a
a
a
a
a
a
a
a
a
a
a
a
a
a
a
a
v
g
A
A
A
A
A
A
A
A
A
A
A
g
v
a
a
M
g
e
"}
(56,1,1) = {"
e
g
X
X
X
X
X
X
X
X
X
X
X
X
X
g
M
a
a
a
a
a
a
a
a
a
a
a
a
a
a
a
a
a
a
a
a
a
a
a
a
a
a
v
g
A
A
A
A
A
A
A
A
A
A
A
g
v
a
a
M
g
e
"}
(57,1,1) = {"
e
g
X
X
X
X
X
X
X
X
X
X
X
X
X
g
M
a
a
a
a
a
a
a
a
a
a
a
a
a
a
a
a
a
a
a
a
a
a
a
a
a
a
v
g
A
A
A
A
A
A
A
A
A
A
A
g
v
a
a
M
g
e
"}
(58,1,1) = {"
e
g
X
X
X
X
X
X
X
X
X
X
X
X
X
g
M
a
a
a
a
a
a
a
a
a
a
a
a
a
a
a
a
a
a
a
a
a
a
a
a
a
a
v
g
A
A
A
A
A
A
A
A
A
A
A
g
v
a
a
M
g
e
"}
(59,1,1) = {"
e
g
X
X
X
X
X
X
X
X
X
X
X
X
X
g
M
a
a
a
a
a
a
a
a
a
a
a
a
a
a
a
a
a
a
a
a
a
a
a
a
a
a
v
g
g
g
g
g
g
g
g
g
g
g
g
g
v
a
a
M
g
e
"}
(60,1,1) = {"
e
g
X
X
X
X
X
X
X
X
X
X
X
X
X
g
M
a
a
a
a
a
a
a
a
a
a
a
a
a
a
a
a
a
a
a
a
a
a
a
a
a
a
v
v
v
v
v
v
v
v
v
v
v
v
v
v
v
a
a
M
g
e
"}
(61,1,1) = {"
e
g
X
X
X
X
X
X
X
X
X
X
X
X
X
g
M
M
M
M
M
M
M
M
M
M
M
M
M
M
M
M
M
M
M
M
M
M
M
M
M
M
M
M
M
M
M
M
M
M
M
M
M
M
M
M
M
M
M
M
M
g
e
"}
(62,1,1) = {"
e
g
g
g
g
g
g
g
g
g
g
g
g
g
g
g
g
g
g
g
g
g
g
g
g
g
g
g
g
g
g
g
g
g
g
g
g
g
g
g
g
g
g
g
g
g
g
g
g
g
g
g
g
g
g
g
g
g
g
g
g
g
e
"}
(63,1,1) = {"
e
e
e
e
e
e
e
e
e
e
e
e
e
e
e
e
e
e
e
e
e
e
e
e
e
e
e
e
e
e
e
e
e
e
e
e
e
e
e
e
e
e
e
e
e
e
e
e
e
e
e
e
e
e
e
e
e
e
e
e
e
e
e
"}
