//MAP CONVERTED BY dmm2tgm.py THIS HEADER COMMENT PREVENTS RECONVERSION, DO NOT REMOVE
"a" = (
/obj/machinery/power/shuttle_engine/propulsion/left{
	dir = 8
	},
/turf/open/floor/plating,
/area/shuttle/arrival)
"m" = (
/obj/structure/grille,
/obj/structure/window/reinforced/spawner/directional/east,
/turf/open/floor/plating,
/area/shuttle/arrival)
"p" = (
/obj/effect/spawner/structure/window/reinforced/plasma/plastitanium,
/turf/open/floor/plating,
/area/shuttle/arrival)
"s" = (
/obj/structure/chair/comfy/shuttle{
	dir = 4
	},
/obj/machinery/status_display/ai/directional/north,
/obj/machinery/light/red/directional/north,
/obj/effect/turf_decal/box,
/turf/open/floor/pod/light,
/area/shuttle/arrival)
"t" = (
/turf/open/floor/pod/light,
/area/shuttle/arrival)
"u" = (
/obj/structure/chair/comfy/shuttle{
	dir = 4
	},
/obj/machinery/status_display/evac/directional/north,
/obj/effect/turf_decal/box,
/obj/effect/decal/cleanable/dirt,
/turf/open/floor/pod/light,
/area/shuttle/arrival)
"z" = (
/obj/effect/turf_decal/trimline/yellow/line{
	dir = 1
	},
/turf/open/floor/pod/dark,
/area/shuttle/arrival)
"A" = (
/obj/structure/chair/comfy/shuttle{
	dir = 4
	},
/obj/effect/turf_decal/box,
/turf/open/floor/pod/light,
/area/shuttle/arrival)
"C" = (
/turf/closed/wall/mineral/titanium/survival/nodiagonal,
/area/shuttle/arrival)
"I" = (
/obj/docking_port/mobile/arrivals{
	dir = 4
	},
/turf/closed/wall/mineral/titanium/survival/nodiagonal,
/area/shuttle/arrival)
"Q" = (
/obj/effect/turf_decal/trimline/yellow/line{
	dir = 1
	},
/obj/effect/decal/cleanable/dirt,
/turf/open/floor/pod/dark,
/area/shuttle/arrival)
"S" = (
/obj/effect/decal/cleanable/dirt,
/turf/open/floor/pod/light,
/area/shuttle/arrival)
"T" = (
/obj/machinery/door/airlock/survival_pod/glass,
/turf/open/floor/pod/dark,
/area/shuttle/arrival)
"U" = (
/obj/machinery/light/red/directional/south,
/obj/structure/closet,
/obj/item/clothing/under/rank/prisoner,
/obj/item/clothing/under/rank/prisoner,
/obj/item/clothing/under/rank/prisoner,
/obj/item/clothing/under/rank/prisoner,
/obj/item/clothing/under/rank/prisoner,
/obj/item/clothing/under/rank/prisoner/skirt,
/obj/item/clothing/under/rank/prisoner/skirt,
/obj/item/clothing/under/rank/prisoner/skirt,
/obj/item/clothing/under/rank/prisoner/skirt,
/obj/item/clothing/under/rank/prisoner/skirt,
/obj/item/clothing/shoes/sneakers/orange,
/obj/item/clothing/shoes/sneakers/orange,
/obj/item/clothing/shoes/sneakers/orange,
/obj/item/clothing/shoes/sneakers/orange,
/obj/item/clothing/shoes/sneakers/orange,
/obj/item/clothing/shoes/sneakers/orange,
/obj/effect/turf_decal/trimline/yellow/line{
	dir = 1
	},
/obj/effect/decal/cleanable/dirt,
/turf/open/floor/pod/dark,
/area/shuttle/arrival)
"Y" = (
/obj/machinery/power/shuttle_engine/heater{
	dir = 8
	},
/obj/structure/grille,
/obj/structure/window/reinforced/spawner/directional/east,
/turf/open/floor/plating,
/area/shuttle/arrival)

(1,1,1) = {"
C
a
I
a
C
"}
(2,1,1) = {"
C
Y
m
Y
C
"}
(3,1,1) = {"
C
u
A
U
C
"}
(4,1,1) = {"
p
S
t
Q
T
"}
(5,1,1) = {"
C
s
A
z
C
"}
(6,1,1) = {"
p
S
t
Q
p
"}
(7,1,1) = {"
C
p
p
p
C
"}
