//MAP CONVERTED BY dmm2tgm.py THIS HEADER COMMENT PREVENTS RECONVERSION, DO NOT REMOVE
"a" = (
/obj/machinery/power/shuttle_engine/propulsion/left{
	dir = 8
	},
/turf/open/floor/plating,
/area/shuttle/arrival)
"m" = (
/obj/structure/grille,
/obj/structure/window/reinforced/spawner/directional/east,
/turf/open/floor/plating,
/area/shuttle/arrival)
"p" = (
/obj/effect/spawner/structure/window/reinforced/plasma/plastitanium,
/turf/open/floor/plating,
/area/shuttle/arrival)
"s" = (
/obj/structure/chair/comfy/shuttle{
	dir = 4
	},
/obj/machinery/status_display/ai/directional/north,
/obj/machinery/light/red/directional/north,
/turf/open/floor/pod/light,
/area/shuttle/arrival)
"t" = (
/turf/open/floor/pod/light,
/area/shuttle/arrival)
"u" = (
/obj/structure/chair/comfy/shuttle{
	dir = 4
	},
/obj/machinery/status_display/evac/directional/north,
/turf/open/floor/pod/light,
/area/shuttle/arrival)
"z" = (
/turf/open/floor/pod/dark,
/area/shuttle/arrival)
"A" = (
/obj/structure/chair/comfy/shuttle{
	dir = 4
	},
/turf/open/floor/pod/light,
/area/shuttle/arrival)
"C" = (
/turf/closed/wall/mineral/titanium/survival/nodiagonal,
/area/shuttle/arrival)
"Q" = (
/obj/effect/spawner/structure/window/reinforced/plasma/plastitanium,
/obj/docking_port/mobile/arrivals,
/turf/open/floor/plating,
/area/shuttle/arrival)
"T" = (
/obj/machinery/door/airlock/survival_pod/glass,
/turf/open/floor/pod/dark,
/area/shuttle/arrival)
"U" = (
/obj/machinery/light/red/directional/south,
/turf/open/floor/pod/dark,
/area/shuttle/arrival)
"Y" = (
/obj/machinery/power/shuttle_engine/heater{
	dir = 8
	},
/obj/structure/grille,
/obj/structure/window/reinforced/spawner/directional/east,
/turf/open/floor/plating,
/area/shuttle/arrival)

(1,1,1) = {"
C
a
C
a
C
"}
(2,1,1) = {"
C
Y
m
Y
C
"}
(3,1,1) = {"
C
u
A
U
C
"}
(4,1,1) = {"
p
t
t
z
T
"}
(5,1,1) = {"
C
s
A
z
C
"}
(6,1,1) = {"
p
t
t
z
p
"}
(7,1,1) = {"
C
p
Q
p
C
"}
