//MAP CONVERTED BY dmm2tgm.py THIS HEADER COMMENT PREVENTS RECONVERSION, DO NOT REMOVE
"a" = (
/obj/effect/spawner/structure/window/reinforced/plasma/plastitanium,
/turf/open/floor/plating,
/area/shuttle/arrival)
"n" = (
/turf/closed/wall/mineral/titanium/survival,
/area/shuttle/arrival)
"r" = (
/obj/effect/spawner/structure/window/reinforced/plasma/plastitanium,
/obj/docking_port/mobile/arrivals{
	name = "secure arrivals shuttle"
	},
/turf/open/floor/plating,
/area/shuttle/arrival)
"u" = (
/obj/structure/chair/comfy/shuttle{
	dir = 4
	},
/obj/machinery/status_display/evac/directional/north,
/turf/open/floor/pod/light,
/area/shuttle/arrival)
"v" = (
/obj/structure/chair/comfy/shuttle{
	dir = 4
	},
/obj/machinery/status_display/ai/directional/north,
/turf/open/floor/pod/light,
/area/shuttle/arrival)
"y" = (
/turf/closed/wall/mineral/titanium/survival/nodiagonal,
/area/shuttle/arrival)
"A" = (
/obj/machinery/power/shuttle_engine/propulsion/left{
	dir = 8
	},
/turf/open/floor/plating,
/area/shuttle/arrival)
"J" = (
/obj/structure/chair/comfy/shuttle{
	dir = 4
	},
/turf/open/floor/pod/light,
/area/shuttle/arrival)
"M" = (
/obj/machinery/power/shuttle_engine/heater{
	dir = 8
	},
/obj/structure/grille,
/turf/open/floor/plating,
/area/shuttle/arrival)
"O" = (
/turf/open/floor/pod/dark,
/area/shuttle/arrival)
"Q" = (
/obj/machinery/door/airlock/survival_pod/glass,
/turf/open/floor/pod/dark,
/area/shuttle/arrival)
"S" = (
/turf/open/floor/pod/light,
/area/shuttle/arrival)
"X" = (
/obj/structure/grille,
/turf/open/floor/plating,
/area/shuttle/arrival)

(1,1,1) = {"
n
A
y
A
n
"}
(2,1,1) = {"
y
M
X
M
y
"}
(3,1,1) = {"
y
u
J
O
y
"}
(4,1,1) = {"
a
S
S
O
Q
"}
(5,1,1) = {"
y
v
J
O
y
"}
(6,1,1) = {"
a
S
S
O
a
"}
(7,1,1) = {"
n
a
r
a
n
"}
